11111111111111111111111111111111111111
10000000000000000000000000000000110001
10000000000000000000000000000000110001
10000000000000000000000000000000110001
10000000000000000000000000000000110001
10000000000000000000000000000000110001
10000000000000000000000000000000110001
10000000000000000000000000000000110001
10000000000000000000000000000000110001
10000000000000000000000000000000110001
10000000000000000000000000000000110001
10000000000000000000000000000000110001
10000000000000000000000000000000110001
10000000000000000000000000000000110001
1000000000000PEC1000000000000000110001
11111111111111111111111111111111111111