111111111111
100000000001
11P000011001
1000C000C001
100E00000001
111111111111