1111111111111
1000000000C01
1000011111001
1P0011E000001
1111111111111